AF	Afghanistan	Afġānistān
AX	Aland Islands	Aaland	Aland	Ahvenanmaa
AL	Albania	Shqipëri	Shqipëria	Shqipnia
DZ	Algeria	Dzayer	Algérie
AS	American Samoa	Amerika Sāmoa	Amelika Sāmoa	Sāmoa Amelika
AD	Andorra	Principality of Andorra	Principat d'Andorra
AO	Angola	República de Angola	ʁɛpublika de an'ɡɔla
AI	Anguilla	
AQ	Antarctica	
AG	Antigua and Barbuda	
AR	Argentina	Argentine Republic	República Argentina
AM	Armenia	Hayastan	Republic of Armenia	Հայաստանի Հանրապետություն
AW	Aruba	
AU	Australia	
AT	Austria	Österreich	Osterreich	Oesterreich
AZ	Azerbaijan	Republic of Azerbaijan	Azərbaycan Respublikası
BS	Bahamas	Commonwealth of the Bahamas
BH	Bahrain	Kingdom of Bahrain	Mamlakat al-Baḥrayn
BD	Bangladesh	People's Republic of Bangladesh	Gônôprôjatôntri Bangladesh
BB	Barbados	
BY	Belarus	Bielaruś	Republic of Belarus	Белоруссия	Республика Беларусь	Belorussiya	Respublika Belarus’
BE	Belgium	België	Belgie	Belgien	Belgique	Kingdom of Belgium	Koninkrijk België	Royaume de Belgique	Königreich Belgien
BZ	Belize	
BJ	Benin	Republic of Benin	République du Bénin
BM	Bermuda	The Islands of Bermuda	The Bermudas	Somers Isles
BT	Bhutan	Kingdom of Bhutan
BO	Bolivia	Buliwya	Wuliwya	Plurinational State of Bolivia	Estado Plurinacional de Bolivia	Buliwya Mamallaqta	Wuliwya Suyu	Tetã Volívia
BQ	Bonaire, Saint Eustatius and Saba	Boneiru
BA	Bosnia and Herzegovina	Bosnia-Herzegovina	Босна и Херцеговина
BW	Botswana	Republic of Botswana	Lefatshe la Botswana
BV	Bouvet Island	Bouvetøya	Bouvet-øya
BR	Brazil	Brasil	Federative Republic of Brazil	República Federativa do Brasil
IO	British Indian Ocean Territory	
VG	British Virgin Islands	
BN	Brunei	Nation of Brunei	 the Abode of Peace
BG	Bulgaria	Republic of Bulgaria	Република България
BF	Burkina Faso	
BI	Burundi	Republic of Burundi	Republika y'Uburundi	République du Burundi
CV	Cabo Verde	Republic of Cabo Verde	República de Cabo Verde
KH	Cambodia	Kingdom of Cambodia
CM	Cameroon	Republic of Cameroon	République du Cameroun
CA	Canada	
KY	Cayman Islands	
CF	Central African Republic	Central African Republic	République centrafricaine
TD	Chad	Tchad	Republic of Chad	République du Tchad
CL	Chile	Republic of Chile	República de Chile
CN	China	Zhōngguó	Zhongguo	Zhonghua	People's Republic of China	中华人民共和国	Zhōnghuá Rénmín Gònghéguó
CX	Christmas Island	Territory of Christmas Island
CC	Cocos Islands	Territory of the Cocos (Keeling) Islands	Keeling Islands
CO	Colombia	Republic of Colombia	República de Colombia
KM	Comoros	Union of the Comoros	Union des Comores	Udzima wa Komori	al-Ittiḥād al-Qumurī
CK	Cook Islands	Kūki 'Āirani
CR	Costa Rica	Republic of Costa Rica	República de Costa Rica
HR	Croatia	Hrvatska	Republic of Croatia	Republika Hrvatska
CU	Cuba	Republic of Cuba	República de Cuba
CW	Curacao	Curacao	Kòrsou	Country of Curaçao	Land Curaçao	Pais Kòrsou
CY	Cyprus	Kýpros	Kıbrıs	Republic of Cyprus	Κυπριακή Δημοκρατία	Kıbrıs Cumhuriyeti
CZ	Czechia	Česká republika	Česko
CD	Democratic Republic of the Congo	DR Congo	Congo-Kinshasa	DRC
DK	Denmark	Danmark	Kingdom of Denmark	Kongeriget Danmark
DJ	Djibouti	Jabuuti	Gabuuti	Republic of Djibouti	République de Djibouti	Gabuutih Ummuuno	Jamhuuriyadda Jabuuti
DM	Dominica	Dominique	Wai‘tu kubuli	Commonwealth of Dominica
DO	Dominican Republic	
EC	Ecuador	Republic of Ecuador	República del Ecuador
EG	Egypt	Arab Republic of Egypt
SV	El Salvador	Republic of El Salvador	República de El Salvador
GQ	Equatorial Guinea	Republic of Equatorial Guinea	República de Guinea Ecuatorial	République de Guinée équatoriale	República da Guiné Equatorial
ER	Eritrea	State of Eritrea	ሃገረ ኤርትራ	Dawlat Iritriyá	ʾErtrā	Iritriyā	
EE	Estonia	Eesti	Republic of Estonia	Eesti Vabariik
SZ	Eswatini	weSwatini	Swatini	Ngwane	Kingdom of Swaziland	Umbuso waseSwatini
ET	Ethiopia	ʾĪtyōṗṗyā	Federal Democratic Republic of Ethiopia	የኢትዮጵያ ፌዴራላዊ ዲሞክራሲያዊ ሪፐብሊክ
FK	Falkland Islands	Islas Malvinas
FO	Faroe Islands	Føroyar	Færøerne
FJ	Fiji	Viti	Republic of Fiji	Matanitu ko Viti	Fijī Gaṇarājya
FI	Finland	Suomi	Republic of Finland	Suomen tasavalta	Republiken Finland
FR	France	French Republic	République française
GF	French Guiana	Guiana	Guyane
PF	French Polynesia	Polynésie française	French Polynesia	Pōrīnetia Farāni
TF	French Southern Territories	
GA	Gabon	Gabonese Republic	République Gabonaise
GM	Gambia	Republic of the Gambia
GE	Georgia	Sakartvelo
DE	Germany	Federal Republic of Germany	Bundesrepublik Deutschland
GH	Ghana	
GI	Gibraltar	
GR	Greece	Elláda	Hellenic Republic	Ελληνική Δημοκρατία
GL	Greenland	Grønland
GD	Grenada	
GP	Guadeloupe	Gwadloup
GU	Guam	Guåhån
GT	Guatemala	
GG	Guernsey	Bailiwick of Guernsey	Bailliage de Guernesey
GN	Guinea	Republic of Guinea	République de Guinée
GW	Guinea-Bissau	Republic of Guinea-Bissau	República da Guiné-Bissau
GY	Guyana	Co-operative Republic of Guyana
HT	Haiti	Republic of Haiti	République d'Haïti	Repiblik Ayiti
HM	Heard Island and McDonald Islands	
HN	Honduras	Republic of Honduras	República de Honduras
HK	Hong Kong	香港
HU	Hungary	
IS	Iceland	Island	Republic of Iceland	Lýðveldið Ísland
IN	India	Bhārat	Republic of India	Bharat Ganrajya
ID	Indonesia	Republic of Indonesia	Republik Indonesia
IR	Iran	Islamic Republic of Iran	Jomhuri-ye Eslāmi-ye Irān
IQ	Iraq	Republic of Iraq	Jumhūriyyat al-‘Irāq
IE	Ireland	Éire	Republic of Ireland	Poblacht na hÉireann
IM	Isle of Man	Ellan Vannin	Mann	Mannin
IL	Israel	State of Israel	Medīnat Yisrā'el
IT	Italy	Italian Republic	Repubblica italiana
CI	Ivory Coast	Ivory Coast	Republic of Côte d'Ivoire	République de Côte d'Ivoire
JM	Jamaica	
JP	Japan	Nippon	Nihon
JE	Jersey	Bailiwick of Jersey	Bailliage de Jersey	Bailliage dé Jèrri
JO	Jordan	Hashemite Kingdom of Jordan	al-Mamlakah al-Urdunīyah al-Hāshimīyah
KZ	Kazakhstan	Qazaqstan	Казахстан	Republic of Kazakhstan	Қазақстан Республикасы	Qazaqstan Respublïkası	Республика Казахстан	Respublika Kazakhstan
KE	Kenya	Republic of Kenya	Jamhuri ya Kenya
KI	Kiribati	Republic of Kiribati	Ribaberiki Kiribati
XK	Kosovo	Република Косово
KW	Kuwait	State of Kuwait	Dawlat al-Kuwait
KG	Kyrgyzstan	Киргизия	Kyrgyz Republic	Кыргыз Республикасы	Kyrgyz Respublikasy
LA	Laos	Lao	Lao People's Democratic Republic	Sathalanalat Paxathipatai Paxaxon Lao
LV	Latvia	Republic of Latvia	Latvijas Republika
LB	Lebanon	Lebanese Republic	Al-Jumhūrīyah Al-Libnānīyah
LS	Lesotho	Kingdom of Lesotho	Muso oa Lesotho
LR	Liberia	Republic of Liberia
LY	Libya	State of Libya	Dawlat Libya
LI	Liechtenstein	Principality of Liechtenstein	Fürstentum Liechtenstein
LT	Lithuania	Republic of Lithuania	Lietuvos Respublika
LU	Luxembourg	Grand Duchy of Luxembourg	Grand-Duché de Luxembourg	Großherzogtum Luxemburg	Groussherzogtum Lëtzebuerg
MO	Macao	澳门	Macao Special Administrative Region of the People's Republic of China	中華人民共和國澳門特別行政區	Região Administrativa Especial de Macau da República Popular da China
MG	Madagascar	Republic of Madagascar	Repoblikan'i Madagasikara	République de Madagascar
MW	Malawi	Republic of Malawi
MY	Malaysia	
MV	Maldives	Maldive Islands	Republic of the Maldives	Dhivehi Raajjeyge Jumhooriyya
ML	Mali	Republic of Mali	République du Mali
MT	Malta	Republic of Malta	Repubblika ta' Malta
MH	Marshall Islands	Republic of the Marshall Islands	Aolepān Aorōkin M̧ajeļ
MQ	Martinique	
MR	Mauritania	Islamic Republic of Mauritania	al-Jumhūriyyah al-ʾIslāmiyyah al-Mūrītāniyyah
MU	Mauritius	Republic of Mauritius	République de Maurice
YT	Mayotte	Department of Mayotte	Département de Mayotte
MX	Mexico	Mexicanos	United Mexican States	Estados Unidos Mexicanos
FM	Micronesia	Federated States of Micronesia
MD	Moldova	Republic of Moldova	Republica Moldova
MC	Monaco	Principality of Monaco	Principauté de Monaco
MN	Mongolia	
ME	Montenegro	Crna Gora
MS	Montserrat	
MA	Morocco	Kingdom of Morocco	Al-Mamlakah al-Maġribiyah
MZ	Mozambique	Republic of Mozambique	República de Moçambique
MM	Myanmar	Burma	Republic of the Union of Myanmar	Pyidaunzu Thanmăda Myăma Nainngandaw
NA	Namibia	Namibië	Republic of Namibia
NR	Nauru	Naoero	Pleasant Island	Republic of Nauru	Ripublik Naoero
NP	Nepal	Federal Democratic Republic of Nepal	Loktāntrik Ganatantra Nepāl
AN	Netherlands Antilles	
NC	New Caledonia	
NZ	New Zealand	Aotearoa
NI	Nicaragua	Republic of Nicaragua	República de Nicaragua
NE	Niger	Nijar	Republic of Niger	République du Niger
NG	Nigeria	Nijeriya	Naíjíríà	Federal Republic of Nigeria
NU	Niue	
NF	Norfolk Island	Territory of Norfolk Island	Teratri of Norf'k Ailen
KP	North Korea	Democratic People's Republic of Korea	조선민주주의인민공화국	Chosŏn Minjujuŭi Inmin Konghwaguk
MK	North Macedonia	Republic of Macedonia	Република Македонија
MP	Northern Mariana Islands	Commonwealth of the Northern Mariana Islands	Sankattan Siha Na Islas Mariånas
NO	Norway	Norge	Noreg	Kingdom of Norway	Kongeriket Norge	Kongeriket Noreg
OM	Oman	Sultanate of Oman	Salṭanat ʻUmān
PK	Pakistan	Pākistān	Islamic Republic of Pakistan	Islāmī Jumhūriya'eh Pākistān
PW	Palau	Republic of Palau	Beluu er a Belau
PS	Palestinian Territory	State of Palestine	Dawlat Filasṭin
PA	Panama	Republic of Panama	República de Panamá
PG	Papua New Guinea	Independent State of Papua New Guinea	Independen Stet bilong Papua Niugini
PY	Paraguay	Republic of Paraguay	República del Paraguay	Tetã Paraguái
PE	Peru	Republic of Peru	 República del Perú
PH	Philippines	Republic of the Philippines	Repúblika ng Pilipinas
PN	Pitcairn	Pitcairn Henderson Ducie and Oeno Islands
PL	Poland	Republic of Poland	Rzeczpospolita Polska
PT	Portugal	Portuguesa	Portuguese Republic	República Portuguesa
PR	Puerto Rico	Commonwealth of Puerto Rico	Estado Libre Asociado de Puerto Rico
QA	Qatar	State of Qatar	Dawlat Qaṭar
CG	Republic of the Congo	Congo-Brazzaville
RE	Reunion	Reunion
RO	Romania	Rumania	Roumania	România
RU	Russia	Rossiya	Russian Federation	Российская Федерация	Rossiyskaya Federatsiya
RW	Rwanda	Republic of Rwanda	Repubulika y'u Rwanda	République du Rwanda
BL	Saint Barthelemy	St. Barthelemy	Collectivity of Saint Barthélemy	Collectivité de Saint-Barthélemy
SH	Saint Helena	
KN	Saint Kitts and Nevis	Federation of Saint Christopher and Nevis
LC	Saint Lucia	
MF	Saint Martin	Collectivity of Saint Martin	Collectivité de Saint-Martin
PM	Saint Pierre and Miquelon	Collectivité territoriale de Saint-Pierre-et-Miquelon
VC	Saint Vincent and the Grenadines	
WS	Samoa	Independent State of Samoa	Malo Saʻoloto Tutoʻatasi o Sāmoa
SM	San Marino	Republic of San Marino	Repubblica di San Marino
ST	Sao Tome and Principe	Democratic Republic of São Tomé and Príncipe	República Democrática de São Tomé e Príncipe
SA	Saudi Arabia	Kingdom of Saudi Arabia	Al-Mamlakah al-‘Arabiyyah as-Su‘ūdiyyah
SN	Senegal	Republic of Senegal	République du Sénégal
RS	Serbia	Srbija	Republic of Serbia	Република Србија	Republika Srbija
CS	Serbia and Montenegro	
SC	Seychelles	Republic of Seychelles	Repiblik Sesel	République des Seychelles
SL	Sierra Leone	Republic of Sierra Leone
SG	Singapore	Singapura	Republik Singapura	新加坡共和国
SX	Sint Maarten	
SK	Slovakia	Slovak Republic	Slovenská republika
SI	Slovenia	Republic of Slovenia	Republika Slovenija
SB	Solomon Islands	
SO	Somalia	aṣ-Ṣūmāl	Federal Republic of Somalia	Jamhuuriyadda Federaalka Soomaaliya	Jumhūriyyat aṣ-Ṣūmāl al-Fiderāliyya
ZA	South Africa	RSA	Suid-Afrika	Republic of South Africa
GS	South Georgia and the South Sandwich Islands	South Georgia and the South Sandwich Islands
KR	South Korea	Republic of Korea
SS	South Sudan	
ES	Spain	Kingdom of Spain	Reino de España
LK	Sri Lanka	ilaṅkai	Democratic Socialist Republic of Sri Lanka
SD	Sudan	Republic of the Sudan	Jumhūrīyat as-Sūdān
SR	Suriname	Sarnam	Sranangron	Republic of Suriname	Republiek Suriname
SJ	Svalbard and Jan Mayen	Svalbard and Jan Mayen Islands
SE	Sweden	Kingdom of Sweden	Konungariket Sverige
CH	Switzerland	Swiss Confederation	Schweiz	Suisse	Svizzera	Svizra
SY	Syria	Syrian Arab Republic	Al-Jumhūrīyah Al-ʻArabīyah As-Sūrīyah
TW	Taiwan	Táiwān	Republic of China	中華民國	Zhōnghuá Mínguó
TJ	Tajikistan	Toçikiston	Republic of Tajikistan	Ҷумҳурии Тоҷикистон	Çumhuriyi Toçikiston
TZ	Tanzania	United Republic of Tanzania	Jamhuri ya Muungano wa Tanzania
TH	Thailand	Prathet	Thai	Kingdom of Thailand	ราชอาณาจักรไทย	Ratcha Anachak Thai
NL	The Netherlands	Holland	Nederland
TL	Timor Leste	East Timor	Democratic Republic of Timor-Leste	República Democrática de Timor-Leste	Repúblika Demokrátika Timór-Leste
TG	Togo	Togolese	Togolese Republic	République Togolaise
TK	Tokelau	
TO	Tonga	
TT	Trinidad and Tobago	Republic of Trinidad and Tobago
TN	Tunisia	Republic of Tunisia	al-Jumhūriyyah at-Tūnisiyyah
TR	Turkey	Turkiye	Republic of Turkey	Türkiye Cumhuriyeti
TM	Turkmenistan	
TC	Turks and Caicos Islands	
TV	Tuvalu	
VI	U.S. Virgin Islands	
UG	Uganda	Republic of Uganda	Jamhuri ya Uganda
UA	Ukraine	Ukrayina
AE	United Arab Emirates	UAE
GB	United Kingdom	UK	Great Britain
US	United States	USA	United States of America United States	United States of America	America	the States	US	U.S.	U.S.A.
UM	United States Minor Outlying Islands	
UY	Uruguay	Oriental Republic of Uruguay	República Oriental del Uruguay
UZ	Uzbekistan	Republic of Uzbekistan	O‘zbekiston Respublikasi	Ўзбекистон Республикаси
VU	Vanuatu	Republic of Vanuatu	Ripablik blong Vanuatu	République de Vanuatu
VA	Vatican	Vatican City State	Stato della Città del Vaticano
VE	Venezuela	Bolivarian Republic of Venezuela	República Bolivariana de Venezuela
VN	Vietnam	Socialist Republic of Vietnam	Cộng hòa Xã hội chủ nghĩa Việt Nam
WF	Wallis and Futuna	Territory of the Wallis and Futuna Islands	Territoire des îles Wallis et Futuna
EH	Western Sahara	Taneẓroft Tutrimt
YE	Yemen	Yemeni Republic	al-Jumhūriyyah al-Yamaniyyah
ZM	Zambia	Republic of Zambia
ZW	Zimbabwe	Republic of Zimbabwe
